1111111111111111111
1P00000000000000001
1000N00011011111101
10000001110111C1101
10N0001110011001101
1000011100010011101
1000111000000110001
10011100N0011100101
10111C0000011001101
1011111111011C11101
1011111111011111101
1000000011000000001
10N00N00110N0000N01
1000000011000000001
10000000000000000E1
1111111111111111111