1111111
1P00001
100N0C0
1000001
10E0001
10000C1
1111111
