1111111
1P00001
100N0C1
1000001
10E0NN1
1000NC1
1111111