11111111111111111
1E100000000010001
10N01111111010101
10001C001N1011101
11101110100010001
10100000101110101
10101111101000101
10101000001011101
10001011N11011101
111N1000001000101
10001011101110101
10101000101C10101
10101110101010111
101000101000N0001
10110010101111111
100100001000000P1
11111111111111111