111111111111111
11v000100000hE1
1100001000h0011
1P0Vv0C00000011
1100001000h0011
11000V100000h01
111111111111111