111111111111111
11N0001000000E1
110000000000011
1P0NN1C10000011
110000100000011
11000N100000N01
111111111111111