1 1 1 1 1
1 1 E P 1
1 0 0 0 1
1 0 N C 1
11111
