1 1 1 1 1
1 1 E 0 1
1 0 N 0 1
1 P 0 C 1
1 1 1 1 1
