1 1 1 1 1 1 1 1 1 1 1 1 1 1 1 1 
1 0 N 0 0 E 1 1 0 1 1 1 1 1 P 1
1 0 0 0 N 1 1 0 0 1 0 0 1 1 0 1
1 0 0 0 1 1 0 0 0 0 0 1 1 0 0 1
1 0 0 1 1 C 0 0 0 0 1 1 0 0 0 1
1 0 1 1 1 1 1 1 0 1 1 0 0 1 0 1
1 0 1 1 1 1 1 1 0 1 1 1 1 1 0 1
1 0 0 0 0 C 1 1 0 0 0 0 0 0 0 1
1 0 0 0 0 0 1 1 0 0 0 0 0 0 0 1
1 0 0 0 0 0 0 0 0 0 0 0 0 0 0 1
1 1 1 1 1 1 1 1 1 1 1 1 1 1 1 1