1111111
11E1111
1N000N1
111C111
1000N01
11C1111
1N00001
1111C11
10000N1
111P111
1111111