1111111111111111111111
110C000000000000000011
110000N000000000000011
110000000N00000N000011
10000N000000N000000001
1EN00000000C00000000P1
10C00N000000N000000001
110000000N00000N000011
110000N000000000C00011
1100000000000000000011
1111111111111111111111